{
  "templates": [
    {
      "id": "start_plain",
      "roomType": "start",
      "weight": 1,
      "grid": [
        "...............",
        "...............",
        "...............",
        "...............",
        ".......#.......",
        "...............",
        "...............",
        "...............",
        "..............."
      ]
    },
    {
      "id": "normal_cross",
      "roomType": "normal",
      "weight": 3,
      "grid": [
        "...............",
        ".......b.......",
        "..m.#..m..#.m..",
        "...............",
        "....b.....b....",
        "...............",
        "..m.#..m..#.m..",
        "...............",
        "..............."
      ]
    },
    {
      "id": "normal_box",
      "roomType": "normal",
      "weight": 2,
      "grid": [
        "...............",
        ".......b.......",
        "..m...#.#...m..",
        "...............",
        "...b.......b...",
        "...............",
        "..m...#.#...m..",
        ".......b.......",
        "..............."
      ]
    },
    {
      "id": "normal_pillars",
      "roomType": "normal",
      "weight": 2,
      "grid": [
        "...............",
        "...m.......m...",
        ".....#...#.....",
        "...............",
        "...b...m...b...",
        "...............",
        ".....#...#.....",
        "...m.......m...",
        "..............."
      ]
    },
    {
      "id": "treasure_center",
      "roomType": "treasure",
      "weight": 1,
      "grid": [
        "...............",
        "...............",
        "....#.....#....",
        "...............",
        ".......r.......",
        "...............",
        "....#.....#....",
        "...............",
        "..............."
      ]
    },
    {
      "id": "boss_default",
      "roomType": "boss",
      "weight": 1,
      "grid": [
        "...............",
        "...............",
        "...............",
        "....#.....#....",
        "...............",
        "...............",
        ".......#.......",
        "...............",
        "..............."
      ]
    }
  ]
}
